x:7 y:8
0 0 4 0 0 0 4 
0 0 0 0 0 0 0
2 0 8 0 2 0 0
0 0 0 0 0 0 2
0 0 4 0 0 0 0
0 0 0 0 0 0 0
0 0 0 0 0 0 0
2 0 6 0 0 2 0
