x:7 y:10
2 0 4 0 2 0 2
0 0 0 1 0 2 0
4 0 6 0 1 0 3
0 0 0 2 0 4 0
1 0 2 0 0 0 0
0 0 0 1 0 0 3
2 0 3 0 0 3 0
0 0 0 0 0 0 1
0 0 2 0 1 0 0
2 0 0 3 0 3 0