x:10 y:14
2 0 2 0 3 0 0 6 0 4
0 3 0 3 0 1 0 0 0 0
3 0 0 0 0 0 0 0 0 0
0 4 0 0 4 0 0 6 0 4
3 0 0 1 0 0 0 0 0 0
0 3 0 0 4 0 1 0 0 0
2 0 0 2 0 2 0 6 0 4
0 2 0 0 3 0 4 0 4 0
2 0 0 0 0 0 0 0 0 1
0 4 0 5 0 3 0 1 0 0
3 0 1 0 4 0 6 0 5 0
0 1 0 0 0 0 0 0 0 2
0 0 0 0 3 0 5 0 3 0
3 0 3 0 0 2 0 2 0 3