x:10 y:14
0 2 0 3 0 0 2 0 2 0
0 0 0 0 1 0 0 2 0 1
1 0 0 0 0 0 0 0 2 0
0 2 0 4 0 0 0 3 0 2
3 0 3 0 0 3 0 0 3 0
0 2 0 1 0 0 0 0 0 2
2 0 3 0 0 0 0 1 0 0
0 4 0 5 0 4 0 0 1 0
3 0 2 0 0 0 0 0 0 0
0 3 0 6 0 5 0 3 0 3
4 0 1 0 1 0 0 0 0 0
0 1 0 2 0 0 1 0 0 3
3 0 2 0 0 2 0 1 0 0
0 1 0 0 3 0 3 0 0 3