x:9 y:13
1 0 3 0 0 4 0 1 0
0 0 0 0 0 0 1 0 2
0 2 0 4 0 2 0 0 0
2 0 2 0 2 0 0 3 0
0 1 0 3 0 1 0 0 2
4 0 3 0 2 0 0 2 0
0 1 0 3 0 2 0 0 4
3 0 1 0 3 0 0 2 0
0 0 0 0 0 0 1 0 4
3 0 0 3 0 0 0 1 0
0 0 0 0 3 0 2 0 4
0 1 0 2 0 0 0 0 0
2 0 2 0 4 0 2 0 2
