x:9 y:13
0 3 0 3 0 3 0 0 2
1 0 2 0 3 0 1 0 0
0 2 0 1 0 2 0 0 2
2 0 4 0 3 0 2 0 0
0 1 0 2 0 3 0 0 0
2 0 4 0 0 0 4 0 4
0 2 0 0 2 0 0 2 0
3 0 3 0 0 0 0 0 3
0 2 0 0 0 2 0 3 0
0 0 4 0 6 0 3 0 0
3 0 0 0 0 0 0 0 3
0 3 0 0 3 0 1 0 0
3 0 0 3 0 2 0 0 2
