x:10 y:14
1 0 0 3 0 3 0 0 3 0
0 0 0 0 3 0 0 2 0 1
3 0 0 3 0 0 1 0 4 0
0 0 0 0 2 0 0 3 0 2
3 0 0 4 0 0 2 0 2 0
0 1 0 0 0 0 0 3 0 3
2 0 0 0 2 0 3 0 2 0
0 4 0 6 0 0 0 3 0 3
2 0 0 0 0 2 0 0 2 0
0 4 0 4 0 0 0 0 0 2
2 0 0 0 0 4 0 2 0 0
0 6 0 4 0 0 0 0 1 0
1 0 0 0 0 2 0 2 0 2
0 4 0 4 0 0 2 0 1 0
