x:10 y:14
2 0 0 2 0 3 0 0 2 0
0 0 3 0 3 0 0 3 0 2
0 0 0 2 0 1 0 0 1 0
2 0 2 0 1 0 0 2 0 3
0 0 0 3 0 0 3 0 3 0
2 0 2 0 0 0 0 0 0 3
0 0 0 4 0 2 0 0 2 0
0 0 3 0 1 0 2 0 0 2
3 0 0 0 0 1 0 0 3 0
0 0 0 3 0 0 0 2 0 2
5 0 4 0 2 0 2 0 0 0
0 0 0 0 0 0 0 0 2 0
0 1 0 2 0 0 2 0 0 1
3 0 2 0 2 0 0 0 2 0
