x:7 y:10
0 1 -3 2 -3 -3 2
3 -4 6 -4 2 0 -1
-1 0 -2 0 0 0 -1
-1 0 3 -3 2 -3 4
3 -3 -3 3 -3 1 -2
-1 2 0 -1 3 -4 5
3 -2 0 1 -1 2 -1
-2 3 -3 -3 2 -2 3
3 -3 2 -3 -3 3 -2
0 1 -3 2 -3 -3 3
