x:8 y:11
0 3 -4 3 -3 3 -3 3
2 -1 1 -3 2 -1 0 -2
-2 3 -4 2 -1 -1 1 -2
6 -4 2 0 -1 1 -1 3
-2 2 -3 -3 4 -3 3 -1
-2 -1 0 2 -1 0 -1 3
4 -1 0 -2 2 0 -1 -2
-2 3 -4 4 -1 0 2 -2
3 -3 2 -3 3 0 -1 3
0 0 0 0 -1 0 1 -1
0 1 -3 -3 3 -3 -3 2
