x:8 y:11
3 -3 3 -4 6 -4 3 0
-2 2 -3 3 -2 0 -1 0
-2 -1 0 -2 3 0 -1 1
3 -1 0 2 -1 0 1 -1
-1 3 -3 -3 5 -3 -3 2
2 -1 0 0 -2 0 0 0
-1 -1 1 -3 5 -3 -3 3
-1 5 -4 3 -1 0 0 -2
3 -2 0 -1 -1 1 -3 3
-2 2 0 -1 3 -4 2 0
3 -3 -3 3 -3 3 -4 2
