x:8 y:11
2 -3 3 -4 -4 -4 3 0
-1 1 -3 -3 2 0 -1 2
-1 0 0 0 -1 0 1 -2
3 -3 5 -4 4 -3 -3 5
-1 2 -2 3 -3 -3 2 -2
3 -2 2 -2 2 0 -1 3
-2 3 -3 4 -2 0 2 -1
6 -4 3 -1 4 0 -1 3
-2 0 -1 1 -2 0 -1 -2
-2 0 2 -3 4 -3 2 -2
2 0 0 2 -4 3 -3 3
