x:9 y:13
2 -4 5 -3 -3 -3 2 0 1
0 0 -2 0 2 0 -1 0 -1
3 -3 3 0 -2 0 3 -4 4
-2 0 0 0 -2 0 0 0 -1
3 -3 5 -4 6 -4 -4 2 -1
0 0 -2 3 -3 2 -3 -3 3
2 -3 3 -2 1 -3 2 0 -1
-1 2 -4 8 -4 2 -1 0 -1
3 0 1 -2 2 -4 5 -3 3
-2 0 -1 3 -3 1 -1 0 -1
4 0 -1 0 0 0 1 0 -1
-2 0 2 -3 3 -4 -4 -4 3
3 -3 -3 3 -4 -4 2 0 0
