x:9 y:13
3 -4 3 -3 4 -3 -3 3 0
-1 0 0 0 -2 0 0 -2 1
2 -3 -3 3 -2 0 1 -2 -1
0 0 0 -2 3 0 -1 2 -1
3 -3 -3 3 -1 0 2 -3 3
-2 0 2 -4 6 -3 -3 3 -1
-2 3 -3 2 -2 0 2 -2 2
-2 -2 1 -1 -2 0 -2 2 -1
3 -2 -1 -1 5 -4 8 -4 4
-1 2 -1 2 -1 2 -2 1 -1
4 -4 3 -1 1 -2 2 -1 1
-1 0 0 -1 0 -2 0 -1 0
3 -4 -4 5 -4 5 -3 2 0
