x:10 y:14
2 0 4 -4 4 -4 3 -3 2 0
-2 0 -2 2 -4 4 -4 3 -1 0
5 -4 8 -4 4 -4 2 -1 -1 1
-1 1 -2 0 0 0 0 -1 2 -1
2 -1 4 -4 5 -3 -3 4 -1 3
-1 3 -3 1 -2 0 0 -2 1 -2
2 -1 0 0 -2 2 -4 5 -3 4
-1 -1 3 -4 8 -4 2 0 0 0
2 -1 -1 0 -2 1 -3 -3 2 -1
-1 2 -1 0 5 -4 -4 2 -1 -1
2 -1 1 0 -1 0 0 0 -1 2
-1 3 -4 -4 6 -3 -3 -3 3 -1
3 -4 2 0 -2 0 0 0 -1 1
0 1 -3 -3 3 0 2 -3 3 0
