x:7 y:10
2 0 2 0 0 2 0
0 0 0 0 0 0 1
6 0 5 0 3 0 0
0 1 0 0 0 0 3
3 0 1 0 0 1 0
0 3 0 0 8 0 5
4 0 2 0 0 0 0
0 2 0 0 5 0 2
2 0 0 1 0 0 0
0 0 2 0 5 0 3
