x:7 y:10
0 1 0 2 0 0 2
3 0 6 0 2 0 0
0 0 0 0 0 0 0
0 0 3 0 2 0 4
3 0 0 3 0 1 0
0 2 0 0 3 0 5
3 0 0 1 0 2 0
0 3 0 0 2 0 3
3 0 2 0 0 3 0
0 1 0 2 0 0 3
