x:8 y:11
3 0 3 0 6 0 3 0
0 2 0 3 0 0 0 0
0 0 0 0 3 0 0 1
3 0 0 2 0 0 1 0
0 3 0 0 5 0 0 2
2 0 0 0 0 0 0 0
0 0 1 0 5 0 0 3
0 5 0 3 0 0 0 0
3 0 0 0 0 1 0 3
0 2 0 0 3 0 2 0
3 0 0 3 0 3 0 2
