x:9 y:11
0 2 -4 -4 4 -3 4 -3 2
1 0 0 0 -1 0 -2 1 -1
-1 2 -3 1 -1 0 2 -1 2
2 -1 1 -3 5 -4 -4 4 -1
-1 5 -4 2 -1 0 0 -1 2
2 -2 0 0 -1 3 -4 5 -1
-1 -2 1 -3 2 -1 0 -2 2
-1 3 -3 3 -4 3 0 -2 -1
5 -4 -4 -4 3 -3 -3 3 -1
-2 0 1 -3 -3 2 -3 -3 2
4 -4 -4 3 -3 -3 1 0 0
