x:9 y:11
0 3 -3 -3 4 -3 -3 1 0
1 -2 0 0 -2 1 -3 -3 3
-1 5 -4 -4 6 -3 -3 2 -2
2 -1 0 0 -1 0 2 -1 3
-1 3 -4 2 -1 0 -2 2 -1
4 -3 3 -4 5 -3 4 -1 2
-2 0 0 0 -1 0 -1 1 -1
4 -3 1 0 1 0 -1 0 -1
-1 1 -3 -3 -3 -3 3 0 2
2 -3 -3 2 -3 1 -1 0 -1
0 0 1 -3 2 -3 4 -4 3