x:10 y:14
2 -3 2 -3 3 -4 -4 6 -4 4
-1 3 -4 3 -3 1 0 -2 0 -2
3 -1 0 0 0 0 0 -2 0 -2
-2 4 -3 -3 4 -3 -3 6 -3 4
3 -2 0 1 -2 0 0 -2 0 -1
-1 3 0 -1 4 -3 1 -2 0 -1
2 -1 0 2 -1 2 -4 6 -4 4
-1 2 0 -1 3 -4 4 -4 4 -1
2 -1 0 -1 0 0 0 0 -2 1
-1 4 -4 5 -4 3 -3 1 -2 0
3 -1 1 0 4 -4 6 -4 5 0
-2 1 -1 0 -2 0 -2 0 -1 2
-2 0 -1 0 3 -3 5 -4 3 -2
3 -3 3 -3 -3 2 -3 2 -3 3