x:10 y:14
0 2 -3 3 -3 -3 2 -3 2 0
0 -1 0 -1 1 -3 -3 2 -1 1
1 -1 0 -1 0 0 0 -1 2 -1
-1 2 -3 4 -4 -4 -4 3 -1 2
3 -3 3 -3 -3 3 -3 -3 3 -1
-1 2 -1 1 0 -1 0 0 -1 2
2 -2 3 -1 0 -1 0 1 -1 -1
-1 4 -2 5 -4 4 0 -1 1 -1
3 -2 2 -2 0 -1 0 -1 0 -1
-2 3 -3 6 -4 5 -3 3 -3 3
4 -3 1 -1 1 -1 0 0 0 -1
-1 1 -3 2 -1 -1 1 -3 -3 3
3 -4 2 0 -1 2 -3 1 0 -1
0 1 -3 -3 3 -3 3 -4 -4 3